111111111111
121000000001
101000111001
101000101101
101000101001
101111101011
100000001001
100111111101
100001010001
100100000001
111111111111