############
#2#00000000#
#0#000###00#
#0#000#0##0#
#0#000#0#00#
#0#####0#0##
#0000000#00#
#00#######0#
#0000#0#000#
#00#0000000#
############